┏━━━━━━━━━━━━━━━━━━━┳━━━━━━━┳━━━━━━━┳━━━━━━━━━━━━━━━━━━━━━━━┳━┳━━━━━━━┳━━━┳━━━┳━━━━━┳━━━━━━━┳━━━┳━━━┳━━━━━━━┳━━━━━━━━━┳━┳━━━┳━━━━━━━━━━━━━━━┳━━━━━━━━━━━┳━━━━━┳━┳━┓
┃                   ┃       ┃       ┃                       ┃ ┃       ┃   ┃   ┃     ┃       ┃   ┃   ┃       ┃         ┃ ┃   ┃               ┃           ┃     ┃ ┃ ┃
┃ ╻ ╻ ┏━━━━━━━━━━━╸ ┗━╸ ┏━╸ ╹ ┏━━━╸ ┗━┳━╸ ┏━━━━━━━━━━━━━━━┓ ╹ ┣━┳━┳━┓ ╹ ┏━┛ ╺━┛ ╺━━━┛ ╺━━━━━┛ ╺━┫ ╺━┛ ┏━━━┳━┫         ┃ ┃ ╺━┫ ┏━━━━━┳━┳━━╸ ╺┫           ┣━┳━┓ ╹ ┃ ┃
┃ ┃ ┃ ┃                 ┃     ┃       ┃   ┃               ┃   ┃ ┃ ┃ ┃   ┃                       ┃     ┃   ┃ ╹         ┃ ┃   ┃ ┃     ┃ ┃     ╹           ╹ ┃ ┃   ┃ ┃
┃ ┣━┛ ┃         ┏━━━━━╸ ┣━━━━━┻━┳━━━╸ ┗━╸ ╹               ┣━╸ ╹ ╹ ┃ ╹ ╺━┫ ╺━━━┳━┳━━━━━━━━━╸ ╺━┓ ┃ ┏━━━┛ ╺━┫           ┃ ┃ ┏━┛ ┃     ┃ ┃                   ┃ ╹ ╺━┛ ┃
┃ ┃   ┃         ┃       ┃       ┃                         ┃       ┃     ┃     ┃ ┃             ┃ ┃ ┃       ┃ ╻         ┃ ┃ ┃   ┃     ┃ ┃                 ╻ ┃       ┃
┣━┛ ╻ ┃         ┃ ┏━╸ ╻ ┃ ┏━╸ ╻ ┗━━━━━╸ ╻ ╻               ┣━┳━╸ ┏━┻━╸ ┏━┫ ╺━━━┫ ┃             ┣━┛ ┃ ╺━━━━━┛ ┃         ┃ ┃ ╹ ┏━┫     ┃ ┃     ╻           ┃ ┃ ╺━┳━━━┫
┃   ┃ ┃         ┃ ┃   ┃ ┃ ┃   ┃         ┃ ┃               ┃ ┃   ┃     ┃ ┃     ┃ ┃             ╹   ┃         ┃         ┃ ┃   ┃ ┃     ┃ ┃     ┃           ┃ ┃   ┃   ┃
┃ ╺━┫ ┃         ┣━┻━╸ ┃ ┃ ┃ ┏━┻━━━━━━━━━┻━┫               ┃ ┗━╸ ┗━┳━┓ ┃ ╹ ╺━━━┛ ┃              ╺┓ ┃ ┏━━━━━┓ ┃         ┃ ┃ ┏━┫ ┗╸ ╺━━┛ ┃     ┣━━━━━━━━━━━┛ ┣━╸ ╹ ╺━┫
┃   ┃ ┃         ╹     ┃ ┃ ┃ ┃             ┃               ┃       ┃ ┃ ┃         ┃             ╻ ┃ ┃ ┃     ┃ ┃         ┃ ┃ ┃ ┃         ┃     ┃             ┃       ┃
┣━━━╋━┫          ╺━━━━┛ ┃ ┃ ┃             ┗━━━━━┳━━━━━━━━━┻━━━┓ ╺━┛ ╹ ╹ ╺━━━━━━━┫             ┃ ╹ ╹ ┃     ┃ ┗━━━━━━━━━┫ ╹ ╹ ╹ ╺━━━━━━━┻━┳━━━┛ ╺━┓ ╺━━━━━━━┛ ╺━━━┳━┫
┃   ┃ ┃         ╻       ┃ ┃ ┃                   ┃             ┃                 ┃             ┃     ┃     ┃           ┃                 ┃       ┃               ┃ ┃
┃ ╺━┫ ┗━━━━━━━━━┻━╸ ╻ ╻ ┃ ┃ ┃             ╻ ╺━━━┫             ┣━━━━━╸ ╺━━━┓ ╺━┓ ┃             ┃ ╺━┳━┫     ┗━╸ ╻ ┏━╸ ╺━┛ ┏━━━━━┓ ╺━━━━━━━┻━┓ ┏━━━┻╸ ╺━╸ ╺┳━━━━━┳━┛ ┃
┃   ┃               ┃ ┃ ┃ ┃ ┃             ┃     ┃             ┃           ┃   ┃ ┃             ┃   ┃ ┃         ┃ ┃       ┃     ┃           ┃ ┃           ┃     ┃   ┃
┃ ╺━┻━━━╸ ┏━━━╸ ╻ ╻ ┃ ┃ ┃ ┗━╋━━━━━━━━━━━━━┛ ┏━━━┫             ┃ ╻ ╺━━━┓ ╺━┻━━━┫ ┗━━━━━━━━━━━━━┛ ╺━┛ ┃     ┏━━━╋━┻━━━━━━━┫     ┗━━━┳━━━┳━┳━┛ ┃           ┃     ┗━╸ ┃
┃         ┃     ┃ ┃ ┃ ┃ ┃   ┃               ┃   ┃             ┃ ┃     ┃       ┃                     ┃     ┃   ╹         ╹         ┃   ┃ ┃   ┃           ┃         ┃
┣━━━╸ ╻ ╺━┫ ╻ ╻ ┣━┛ ┃ ┃ ┣━╸ ╹ ╻ ╺━┳━━━━━━━━━┻━┓ ┃             ┃ ┃ ╻ ╻ ┗━━━━━┳━┻━━━┓ ┏━━━━━╸ ╺━┓ ╺━┓ ┃     ┃ ┏╸                ╻ ╺━┛ ╺━┛ ╹ ╺━┫           ┃     ╻ ┏━┫
┃     ┃   ┃ ┃ ┃ ┃   ┃ ┃ ┃     ┃   ┃           ┃ ┃             ┃ ┃ ┃ ┃       ┃     ┃ ┃         ┃   ┃ ┃     ┃ ┃ ╻         ╻     ┃             ┃           ┃     ┃ ┃ ┃
┃ ╻ ┏━┻━╸ ┣━┻━┻━┻━╸ ┃ ┗━┻━┳━╸ ┗━━━┛ ╺━━━━━┓ ╺━┛ ┃             ┃ ┣━┛ ┣━╸ ╺━┓ ┃     ╹ ┃         ┃ ┏━┛ ┗━━╸ ╺┛ ╹ ┃         ┣━━━━━┛ ╺━━━━━┳━━━┓ ┗━━━━━━━━━━━┻━━━━━┛ ╹ ┃
┃ ┃ ┃     ┃         ┃     ┃               ┃     ┃             ┃ ┃   ┃     ┃ ┃       ┃         ┃ ┃             ┃         ┃             ┃   ┃                       ┃
┣━┛ ┃ ┏━━━┛ ╻ ┏━╸ ┏━┻━╸ ╻ ┃ ┏━╸ ╻ ╺━━━┳━╸ ┗━━━┳━┫             ┃ ┗━┳━┛ ╻ ╻ ┗━┫     ┏━┫         ┣━┻━━━━━━━┓ ╺━━━┫         ┣━┓ ╻ ╺━┓ ╻ ╻ ╹ ╻ ┃ ╻ ╺━━━━━━━━━━━━━┓ ╺━━━┫
┃   ┃ ┃     ┃ ┃   ┃     ┃ ┃ ┃   ┃     ┃       ┃ ┃             ┃   ┃   ┃ ┃   ┃     ┃ ┃         ┃         ┃     ┃         ┃ ┃ ┃   ┃ ┃ ┃   ┃ ┃ ┃               ┃     ┃
┃ ╻ ┗━┻━━━━━┻━┛ ╻ ┣━╸ ╻ ┃ ┃ ┗━┓ ┃ ╻ ╺━┻━┳━╸ ╺━┛ ┗╸ ╺┳━┳━━━━━┳━┛ ╺━┫ ╻ ┃ ┗━━━┻╸ ╺━━┛ ┃         ┃         ┃ ╻ ╺━┫         ┃ ┃ ┗━━━┫ ┃ ┃ ╺━┻━┻━┫ ╺━┓ ┏━━━━━┳━╸ ┗━┓ ╻ ┃
┃ ┃             ┃ ┃   ┃ ┃ ┃   ┃ ┃ ┃     ┃           ┃ ┃     ╹     ┃ ┃ ┃             ┃         ┃         ┃ ┃   ┃         ┃ ┃     ┃ ┃ ┃       ┃   ┃ ┃     ┃     ┃ ┃ ┃
┃ ┃         ╻ ╻ ┃ ┗━┳━┛ ┗━┻━━━┫ ┃ ┗━┓ ╺━┻━━━━━━━━━┳━┛ ┃      ╺╸ ╻ ┣━┛ ┗━┓ ╺━━━┳━╸ ╻ ┗━┳━━━┳━━━┛         ┃ ┃ ╻ ┗━━━━━━━━━┛ ╹ ╺━━━┫ ┗━┫ ╺━━━┓ ┗━━━┫ ╹ ╺━━━┫     ┃ ┃ ┃
┃ ┃         ┃ ┃ ┃   ┃         ┃ ┃   ┃             ┃   ┃     ╻   ┃ ┃     ┃     ┃   ┃   ┃   ┃             ┃ ┃ ┃                   ┃   ┃     ┃     ┃       ┃     ┃ ┃ ┃
┃ ┃         ┃ ┣━┻━━━┻━━━━━━━┓ ┗━┫ ╻ ┣━━━━━┓ ╻ ╺━┓ ┃ ┏━┫     ┃ ╻ ┃ ┃ ╻ ╻ ┃ ╺━━━┻━┓ ┃ ╻ ╹ ╺━┛ ┏━┓         ┃ ┃ ┃ ┏━━━━━━━━━━━━━━━┓ ┗━━━╋━━━╸ ┗━━━╸ ┗━━━┓ ╻ ┃     ┃ ┣━┫
┃ ┃         ┃ ┃             ┃   ┃ ┃ ┃     ┃ ┃   ┃ ┃ ┃ ┃     ┃ ┃ ┃ ┃ ┃ ┃ ┃       ┃ ┃ ┃       ┃ ┃         ┃ ┃ ┃ ┃               ┃     ┃               ┃ ┃ ┃     ┃ ┃ ┃
┃ ┗━┳━━━┳━┳━┛ ╹             ┃ ╺━┫ ┗━┫     ┃ ┃ ╻ ┗━┛ ╹ ┃     ┃ ┣━┛ ┣━┛ ┗━┫ ╺━━━┓ ┃ ┗━╋━━━╸ ╺━┛ ┃         ┃ ┃ ┗━┫               ┃ ╻ ╺━┫               ┃ ┗━┫     ┣━┛ ┃
┃   ┃   ┃ ┃                 ┃   ┃   ┃     ┃ ┃ ┃       ┃     ╹ ┃   ┃     ┃     ┃ ┃   ╹         ┃         ┃ ┃   ┃               ┃ ┃   ┃               ┃   ┃     ┃   ┃
┃ ╻ ┗━┓ ┃ ┣━╸ ╻             ┃ ╻ ┃ ╻ ╹     ┣━┛ ┗━┳━━━━━┻━━━━╸ ╺┻━┳━┛ ╺━━━┻━┓ ╻ ┗━┫ ┏╸ ╺━━━━━━━━┻━┳━━━━━┳━┛ ┗━━━┫               ╹ ┃ ╺━┫               ┃ ╻ ┗╸ ╺━━╋━╸ ┃
┃ ┃   ┃ ┃ ┃   ┃             ┃ ┃ ┃ ┃       ┃     ┃               ┃         ┃ ┃   ┃ ┃             ┃     ┃       ┃                 ┃   ┃               ┃ ┃       ┃   ┃
┃ ┣━━━┛ ╹ ╹ ╻ ┗━━━━━╸ ┏━━━━━┛ ┃ ┃ ┃ ╻     ┃ ╺━━━┫               ┃         ┃ ┃ ╻ ┃ ┃             ┣━╸ ╻ ┗━╸ ╻ ╻ ┃               ┏━┛ ╻ ┃               ┃ ┣━╸ ╺━━━┛ ╺━┫
┃ ┃         ┃         ┃       ┃ ┃ ┃ ╹     ┃     ┃               ┃         ┃ ┃ ┃ ┃ ┃             ┃   ┃     ┃ ┃ ┃               ┃   ┃ ┃               ┃ ┃           ┃
┣━┛ ╺━┳━━━━━┻━━━━━━━━━╋━╸ ╻ ╻ ┃ ┗━┫       ┃ ╻ ╻ ┃               ┃         ┃ ┃ ┃ ┗━┫             ┣━╸ ┣━━━━━┻━┻━┫               ┣━╸ ┣━┻━━━━━━━━━━━━━┳━┛ ┣━╸ ╺━━━┓ ╺━┫
┃     ┃               ┃   ┃ ┃ ┃   ┃ ╻     ┃ ┃ ┃ ┃               ┃         ┃ ┃ ┃   ┃             ┃   ┃         ┃               ┃   ┃               ┃   ┃       ┃   ┃
┣━┓ ╻ ┃               ┗━━━┛ ┃ ┣━╸ ┗━┻━┳━━━┛ ┗━┻━┫               ┣━━━━━━━┳━┫ ┃ ┃ ╻ ╹             ┣━┳━┫         ┣━━━┳━┳━━━━━━━┳━┛ ╻ ╹ ╺━━━━━━━┓ ┏━━━┻━━━┻━━━━━━━┫ ╻ ┃
┃ ┃ ┃ ┃                     ┃ ┃       ┃         ┃               ┃       ┃ ┃ ┃ ┃ ┃               ┃ ┃ ┃         ┃   ┃ ┃       ┃   ┃           ┃ ┃               ┃ ┃ ┃
┃ ╹ ┗━┫               ┏━┓ ┏━┻━┻━━╸ ╺┓ ┃ ┏━━━━━━━┛               ┃ ┏━━━╸ ╹ ╹ ┣━┛ ┃ ╻             ┃ ┃ ┃         ┃ ╺━┫ ┃       ┃ ╻ ┗━┓ ╺━━━━━━━┻━┛               ┃ ┃ ┃
┃     ┃               ┃ ┃ ┃         ┃ ┃ ┃                       ┃ ┃         ┃   ┃ ┃             ┃ ┃ ┃         ┃   ┃ ┃       ┃ ┃   ┃                           ┃ ┃ ┃
┃ ╻ ╻ ┗━━━━━━━━━┳━━━━━┛ ╹ ┃         ┃ ┃ ┃       ┏━━━┳━┳━━━┳━━━━━╋━┻━━━━━━━┓ ┣━━━┛ ┗━━━━━━━━━━━━━┛ ╹ ┃         ┃ ┏━┫ ┃       ┃ ┃ ┏━┛ ╺━━━━━┓ ╺━┓               ┃ ┗━┫
┃ ┃ ┃           ┃         ┃         ┃ ┃ ┃       ┃   ┃ ┃   ┃     ┃         ┃ ┃                       ┃         ┃ ┃ ┃ ┃       ┃ ┃ ┃         ┃   ┃               ┃   ┃
┃ ┃ ┣━┳━┓ ╺━━━━━┻━━━━╸ ╺━━┫         ┣━┛ ┃       ┣━┓ ┃ ╹ ╺━┛ ┏━╸ ┃         ┣━┛ ┏━━━━━━━━━━━━━━━╸ ╻ ╻ ┃         ┃ ┃ ╹ ╹       ┃ ┃ ┃         ╹ ╻ ┃               ┃ ╻ ┃
┃ ┃ ┃ ┃ ┃                 ┃         ┃   ┃       ┃ ┃ ┃       ┃   ┃         ┃   ┃                 ┃ ┃ ┃         ┃ ┃           ┃ ┃ ┃           ┃ ┃               ┃ ┃ ┃
┃ ┗━┛ ╹ ┗━┓               ┣━━━━━━━━━┻━╸ ┃       ┃ ┃ ┗━━━━━┳━╋━╸ ┃         ┣━╸ ┃               ╻ ┃ ┃ ┗╸ ╺━━━━━━┛ ┃ ╺━┓       ┣━┛ ┃         ╻ ┗━┻━━━━━━━┳━━━━━━━╋━┫ ┃
┃         ┃               ┃             ┃       ┃ ┃       ┃ ┃   ┃         ┃   ┃               ┃ ┃ ┃             ┃   ┃       ┃   ┃         ┃           ┃       ┃ ┃ ┃
┃ ╻ ╻ ╺━━━┫               ┣━╸ ┏━╸ ┏━╸ ╻ ┃       ┃ ┗━╸ ┏━╸ ╹ ╹ ╻ ┗━━━━╸ ╺━━┛ ╻ ┃               ┃ ┃ ┗━━━┓ ╺━┓ ╻ ╻ ╹ ╻ ┃       ┃ ╺━┫         ┃ ╻ ╺━━━━━━━┛ ╺━━━━━┛ ┃ ┃
┃ ┃ ┃     ┃               ┃   ┃   ┃   ┃ ┃       ┃     ┃       ┃             ┃ ┃               ┃ ┃     ┃   ┃ ┃ ┃   ┃ ┃       ┃   ┃         ┃ ┃                   ┃ ┃
┗━┻━┻━━━━━┻━━━━━━━━━━━━━━━┻━━━┻━━━┻━━━┻━┻━━━━━━━┻━━━━━┻━━━━━━━┻━━━━━━━━━━━━━┻━┻━━━━━━━━━━━━━━━┻━┻━━━━━┻━━━┻━┻━┻━━━┻━┻━━━━━━━┻━━━┻━━━━━━━━━┻━┻━━━━━━━━━━━━━━━━━━━┻━┛