┏━━━━━━━━━┳━┓
┃         ┃ ┃
┃         ┃ ┃
┃         ┃ ┃
┃         ┃ ┃
┃         ┃ ┃
┃         ╹ ┃
┃           ┃
┃         ╻ ┃
┃         ┃ ┃
┣━━━━━━━━━┛ ┃
┃           ┃
┗━━━━━━━━━━━┛