┏━━━┳━━━━━━━━━━━━━━━┳━━━━━━━━━━━━━━━┳━━━━━━━━━━━┳━━━━━━━━━━━━━━━━━━━┓   ┃
┃   ┃               ┃               ┃           ┃                   ┃   ┃
┃   ┃   ━━━━━━━━┓   ┃   ┏━━━┓   ━━━━┻━━━┓   ━━━━┛   ┏━━━┓   ┏━━━━   ┃   ┃
┃               ┃       ┃   ┃           ┃           ┃   ┃   ┃       ┃   ┃
┣━━━━━━━┓   ╷   ┗━━━━━━━┛   ┣━━━━━━━━   ┣━━━┓   ╷   ┃   ┃   ┗━━━━━━━┫   ┃
┃       ┃   ┃               ┃           ┃   ┃   ┃   ┃   ┃           ┃   ┃
┃   ╷   ┗━━━┻━━━━━━━┓   ╷   ┃   ━━━━┳━━━┛   ┗━━━┫   ┃   ┗━━━┳━━━━   ┃   ┃
┃   ┃               ┃   ┃   ┃       ┃           ┃           ┃       ┃   ┃
┃   ┗━━━━━━━┳━━━━   ┣━━━┫   ┗━━━┓   ┃   ━━━━┓   ┗━━━━━━━┓   ┃   ━━━━┛   ┃
┃           ┃       ┃   ┃       ┃   ┃       ┃           ┃   ┃           ┃
┃   ━━━━┓   ┗━━━┓   ┃   ┣━━━━   ┃   ┗━━━┳━━━┛   ╷   ╷   ┃   ┗━━━┳━━━━━━━┫
┃       ┃       ┃   ┃   ┃       ┃       ┃       ┃   ┃   ┃       ┃       ┃
┣━━━━━━━┻━━━┓   ┃   ┃   ┃   ┏━━━┻━━━┓   ┃   ━━━━┫   ┃   ┗━━━┓   ┗━━━━   ┃
┃           ┃   ┃           ┃       ┃   ┃       ┃   ┃       ┃           ┃
┃   ┏━━━━   ┃   ┗━━━━━━━┓   ┗━━━━   ┃   ┗━━━┓   ┣━━━┫   ━━━━┻━━━━━━━┓   ┃
┃   ┃       ┃           ┃           ┃       ┃   ┃   ┃               ┃   ┃
┃   ┃   ━━━━┻━━━┓   ╷   ┣━━━┓   ┏━━━┻━━━━   ┃   ┃   ┗━━━━━━━┳━━━┓   ┃   ┃
┃   ┃           ┃   ┃   ┃   ┃   ┃           ┃               ┃   ┃       ┃
┃   ┣━━━━━━━┓   ┃   ┃   ┃   ┗━━━┫   ━━━━━━━━┫   ┏━━━━━━━┓   ┃   ┗━━━━━━━┫
┃   ┃       ┃   ┃   ┃           ┃           ┃   ┃       ┃               ┃
┃   ┃   ━━━━┛   ┗━━━┛   ┏━━━━   ┗━━━┳━━━━   ┗━━━┛   ╷   ┗━━━━━━━━   ╷   ┃
┃   ┃                   ┃           ┃               ┃               ┃   ┃
┃   ┗━━━━━━━━━━━━━━━━━━━┻━━━━━━━━━━━┻━━━━━━━━━━━━━━━┻━━━━━━━━━━━━━━━┻━━━┛

┌───────────────────┐
│  ╔═══╗ Some Text  │▒
│  ╚═╦═╝ in the box │▒
╞═╤══╩══╤═══════════╡▒
│ ├──┬──┤           │▒
│ └──┴──┘           │▒
└───────────────────┘▒
 ▒▒▒▒▒▒▒▒▒▒▒▒▒▒▒▒▒▒▒▒▒
 