fuck┌───┬───────────┬───────────────┬─┬───────────┬─────┬───────────┬─────────┐
├─┐ ╵ ┌─┬─────╴ ├─────┐ ╶───┬─┐ │ ╵ ╷ ┌─────┐ │ ╷ ╷ │ ╶─┬─╴ ┌───┘ ╶─┐ ┌─┐ │
│ └───┘ │ ╶─┬─┬─┘ ╶─┐ └───╴ │ │ │ ╶─┤ └─┐ ╶─┤ └─┘ │ │ ╷ └─┐ │ ╶─┬───┤ │ ╵ │
│ ┌─╴ ┌─┴─╴ │ ╵ ┌─╴ ├─────┬─┘ ╵ ├─┐ └─┐ │ ╷ └───┬─┤ │ └─┐ ├─┘ ┌─┘ ╷ │ └─┐ │
├─┘ ┌─┘ ┌───┴───┘ ┌─┘ ┌─┐ │ ┌───┘ └─┐ │ └─┤ ╶─┐ ╵ │ └───┘ │ ╶─┤ ╶─┤ ├─╴ │ │
│ ╷ │ ┌─┘ ╷ ┌─┬───┘ ╷ │ │ │ │ ╶─────┘ ├─╴ │ ╷ └───┘ ┌─────┴─╴ └─┐ │ ╵ ┌─┘ │
│ └─┤ └───┘ │ │ ╶───┤ │ ╵ │ │ ┌───────┤ ╶─┤ └───┬───┤ ╶─────┬───┘ ├───┤ ╶─┤
├─╴ ├───────┘ └─┬─┐ │ └───┘ │ │ ┌───┐ │ ╷ ├─╴ ┌─┘ ╷ └─╴ ┌───┘ ┌───┘ ╶─┴─┐ │
│ ┌─┘ ╷ ╶───┬─┐ │ │ └───┬───┤ │ ╵ ╷ │ │ │ └─┬─┘ ┌─┴─┬───┤ ╶───┴───┬─╴ ╷ │ │
│ ╵ ┌─┴───┐ │ ╵ ╵ └───┐ │ ╷ └─┴───┘ │ └─┤ ╷ ╵ ┌─┘ ╷ ╵ ╷ │ ┌─┬───╴ │ ┌─┘ │ │
│ ╶─┤ ╶───┤ └─┐ ┌─────┘ │ ├─────┬───┼─╴ │ └───┤ ┌─┴───┘ │ ╵ │ ┌───┤ └─┐ │ │
├─╴ ├───┐ └─┐ ├─┘ ┌─────┤ └───┐ ╵ ╷ ╵ ┌─┴─┬─╴ │ │ ╶─┬───┴───┘ │ ╷ │ ╷ └─┤ │
│ ╶─┘ ╷ ╵ ╷ │ ╵ ╶─┘ ┌─╴ └───╴ │ ╶─┴───┘ ╷ └───┘ ├─╴ ╵ ┌───────┘ └─┘ └─┐ ╵ │
└─────┴───┴─┴───────┴─────────┴─────────┴───────┴─────┴───────────────┴───┘